#######A#
##   ## #
## ###  #
#       #
#  ### ##
#  ### ##
#      B#
#########